
      const activitiesResponseMonday = await getActivitiesMonday();
      const staffResponseMonday = await getStaffsMonday();
      const dinningResponseMonday = await getDinningMonday();
      const breakfastResponseMonday = await getBreakfastMonday();
      const barsResponseMonday = await getBarsMonday();
      const flyersResponseMonday = await getFlyersMonday();
      const flyersTitleResponseMonday = await getFlyersTitleMonday();

      
      const activitiesResponseTuesday = await getActivitiesTuesday();
      const staffResponseTuesday = await getStaffsTuesday();
      const dinningResponseTuesday = await getDinningTuesday();
      const breakfastResponseTuesday = await getBreakfastTuesday();
      const barsResponseTuesday = await getBarsTuesday();
      const flyersResponseTuesday = await getFlyersTuesday();
      const flyersTitleResponseTuesday = await getFlyersTitleTuesday();
      
      const activitiesResponseWednesday = await getActivitiesWednesday();
      const staffResponseWednesday = await getStaffsWednesday();
      const dinningResponseWednesday = await getDinningWednesday();
      const breakfastResponseWednesday = await getBreakfastWednesday();
      const barsResponseWednesday = await getBarsWednesday();
      const flyersResponseWednesday = await getFlyersWednesday();
      const flyersTitleResponseWednesday = await getFlyersTitleWednesday();
      
      const activitiesResponseThursday = await getActivitiesThursday();
      const staffResponseThursday = await getStaffsThursday();
      const dinningResponseThursday = await getDinningThursday();
      const breakfastResponseThursday = await getBreakfastThursday();
      const barsResponseThursday = await getBarsThursday();
      const flyersResponseThursday = await getFlyersThursday();
      const flyersTitleResponseThursday = await getFlyersTitleThursday();
      
      const activitiesResponseFriday = await getActivitiesFriday();
      const staffResponseFriday = await getStaffsFriday();
      const dinningResponseFriday = await getDinningFriday();
      const breakfastResponseFriday = await getBreakfastFriday();
      const barsResponseFriday = await getBarsFriday();
      const flyersResponseFriday = await getFlyersFriday();
      const flyersTitleResponseFriday = await getFlyersTitleFriday();
      
      const activitiesResponseSaturday = await getActivitiesSaturday();
      const staffResponseSaturday = await getStaffsSaturday();
      const dinningResponseSaturday = await getDinningSaturday();
      const breakfastResponseSaturday = await getBreakfastSaturday();
      const barsResponseSaturday = await getBarsSaturday();
      const flyersResponseSaturday = await getFlyersSaturday();
      const flyersTitleResponseSaturday = await getFlyersTitleSaturday();
      
      const activitiesResponseSunday = await getActivitiesSunday();
      const staffResponseSunday = await getStaffsSunday();
      const dinningResponseSunday = await getDinningSunday();
      const breakfastResponseSunday = await getBreakfastSunday();
      const barsResponseSunday = await getBarsSunday();
      const flyersResponseSunday = await getFlyersSunday();
      const flyersTitleResponseSunday = await getFlyersTitleSunday();

    

      //flyers titles


    
